S00000#000000000
000#00#000000000
000000#000000000
0000###000000000
0000000000000000
00000000H0000000
000000000####000
000000000000#000
000H000H0000#000
0000000000000000
0000#00000000000
0000#####0000###
0000000000000000
0####0000000###0
0000#00000000000
0000#0000000000F