000#####
0000000#
0000F00#
#000000#
#000000#
###0000#
0000000#
########