################
#S0#00000000000#
#00#00000###000#
#00#0000000#000#
#00000#0000#000#
#00000#0000##00#
#000###00000000#
#00000000####00#
#00000000000000#
#####0000000000#
#000#000#000000#
#000#000#000000#
#000000F###0000#
#00000000000000#
#00000000000000#
################