################
#000000000#000S#
#000#00000#0000#
#000#00000#0000#
#000####0000000#
#####0000000000#
#000#000#####00#
#000#0000000#00#
#00000000000000#
#00000000####00#
#00#00000000#00#
#00#00###000#00#
#00#0000#000####
#00####0#000000#
#F000000#000000#
################