0#######
0000000#
0000000#
000F000#
0000000#
0000000#
0000000#
########