################
#000000000#000S#
#000000000#0000#
#####00000#0000#
#00000000000000#
#####0000000000#
#000#00000###00#
#000#0000000#00#
#00000000000000#
#00000000####00#
#00000000000#00#
#000#####000#00#
#00000000000#00#
#00000000000000#
#F0000000000000#
################